//MAP CONVERTED BY dmm2tgm.py THIS HEADER COMMENT PREVENTS RECONVERSION, DO NOT REMOVE
"a" = (
/obj/decal/cleanable/dirt,
/turf/unsimulated/floor/cave,
/area/precursor/unspace/poolroom)
"b" = (
/obj/map/light/cyan/menhir,
/turf/unsimulated/floor/setpieces/bluefloor,
/area/precursor/unspace/poolroom)
"c" = (
/turf/unsimulated/wall/auto/adventure/cave,
/area/precursor/unspace/poolroom)
"g" = (
/turf/unsimulated/floor/cave,
/area/precursor/unspace/poolroom)
"h" = (
/obj/decal/lightshaft,
/turf/unsimulated/floor/cave,
/area/precursor/unspace/poolroom)
"i" = (
/obj/decal/cleanable/dirt,
/obj/decal/mushrooms/type1,
/turf/unsimulated/floor/cave,
/area/precursor/unspace/poolroom)
"m" = (
/obj/landmark/menhir/room{
	tag = "menhir_room_cavern"
	},
/turf/unsimulated/floor/setpieces/bluefloor,
/area/precursor/unspace/poolroom)
"n" = (
/obj/river{
	desc = "It's pouring down from somewhere far above.";
	name = "Waterfall"
	},
/turf/unsimulated/wall/auto/adventure/cave,
/area/precursor/unspace/poolroom)
"q" = (
/obj/decal/cliff/shore{
	dir = 1
	},
/obj/channel{
	required_to_pass = 1e+009
	},
/turf/space/fluid/cenote,
/area/precursor/unspace/poolroom)
"r" = (
/turf/unsimulated/floor/setpieces/bluefloor{
	dir = 1
	},
/area/precursor/unspace/poolroom)
"t" = (
/turf/unsimulated/floor/void/timewarp,
/area/precursor/unspace/poolroom)
"w" = (
/obj/map/light/graveyard{
	brightness = 12
	},
/turf/space/fluid/cenote,
/area/precursor/unspace/poolroom)
"D" = (
/obj/map/light/graveyard{
	brightness = 12
	},
/turf/unsimulated/floor/cave,
/area/precursor/unspace/poolroom)
"H" = (
/obj/machinery/door/unpowered/blue{
	dir = 4
	},
/turf/unsimulated/floor/setpieces/bluefloor,
/area/precursor/unspace/poolroom)
"I" = (
/obj/decal/cleanable/dirt,
/obj/decal/mushrooms/type2,
/turf/unsimulated/floor/cave,
/area/precursor/unspace/poolroom)
"J" = (
/turf/unsimulated/floor/void,
/area/precursor/unspace/poolroom)
"N" = (
/turf/space/fluid/cenote,
/area/precursor/unspace/poolroom)
"Q" = (
/obj/landmark/spawner/artifact/more_precursor,
/turf/unsimulated/floor/setpieces/bluefloor{
	dir = 1
	},
/area/precursor/unspace/poolroom)
"R" = (
/mob/living/critter/small_animal/cockroach,
/turf/unsimulated/floor/cave,
/area/precursor/unspace/poolroom)
"S" = (
/obj/machinery/door/unpowered/blue,
/turf/unsimulated/floor/setpieces/bluefloor,
/area/precursor/unspace/poolroom)
"T" = (
/obj/decal/cleanable/dirt,
/obj/decal/mushrooms/type3,
/turf/unsimulated/floor/cave,
/area/precursor/unspace/poolroom)
"W" = (
/turf/unsimulated/floor/setpieces/bluefloor,
/area/precursor/unspace/poolroom)
"X" = (
/turf/unsimulated/wall/auto/adventure/icemooninterior,
/area/precursor/unspace/poolroom)
"Y" = (
/obj/decal/lightshaft,
/obj/effects/harmless_smoke{
	name = "mist";
	opacity = 0
	},
/turf/space/fluid/cenote,
/area/precursor/unspace/poolroom)

(1,1,1) = {"
t
t
t
t
t
t
t
t
t
t
t
t
t
t
t
J
c
c
c
c
J
J
J
J
"}
(2,1,1) = {"
t
t
t
t
t
t
t
t
t
t
t
t
t
t
t
c
c
i
g
c
c
J
J
J
"}
(3,1,1) = {"
t
t
t
t
t
t
t
t
t
t
t
t
t
t
t
c
g
g
a
T
c
J
J
J
"}
(4,1,1) = {"
t
t
t
t
t
t
t
t
t
t
t
t
t
t
t
c
a
g
g
c
c
J
J
J
"}
(5,1,1) = {"
J
t
t
t
t
t
t
t
t
t
t
t
t
t
c
c
g
g
c
c
c
c
J
J
"}
(6,1,1) = {"
J
J
t
t
t
t
t
t
t
t
t
t
t
c
c
c
g
g
q
N
N
c
c
J
"}
(7,1,1) = {"
J
J
J
t
t
t
t
t
t
t
t
t
c
c
I
g
h
D
q
N
N
c
c
c
"}
(8,1,1) = {"
J
J
J
J
t
t
t
t
t
t
t
c
c
a
g
g
g
g
q
N
N
N
c
c
"}
(9,1,1) = {"
J
J
J
J
J
t
t
t
t
t
J
c
T
a
g
g
g
g
q
N
N
N
N
c
"}
(10,1,1) = {"
J
J
J
J
J
X
t
t
t
X
J
c
c
g
g
i
c
R
q
N
N
N
N
c
"}
(11,1,1) = {"
J
J
J
J
J
X
X
m
X
X
J
c
c
g
g
c
c
c
c
N
N
N
N
c
"}
(12,1,1) = {"
J
J
J
J
J
J
X
r
X
J
J
c
c
a
g
c
c
n
n
Y
w
N
N
c
"}
(13,1,1) = {"
J
J
J
J
J
J
X
b
X
X
X
X
X
g
g
a
c
c
c
N
N
N
c
c
"}
(14,1,1) = {"
J
J
J
J
J
J
X
W
X
r
X
r
X
g
h
D
g
q
N
N
N
N
N
c
"}
(15,1,1) = {"
X
X
X
H
X
X
X
b
W
W
W
b
S
g
g
g
g
q
N
N
N
N
N
c
"}
(16,1,1) = {"
X
r
X
r
X
r
X
W
X
r
X
r
X
I
g
g
g
q
N
N
N
N
N
c
"}
(17,1,1) = {"
X
W
b
W
W
W
W
W
X
X
X
X
X
c
a
g
c
c
N
N
N
N
c
c
"}
(18,1,1) = {"
X
Q
X
r
X
r
X
X
X
J
J
J
c
c
c
c
c
N
N
N
N
c
c
c
"}
(19,1,1) = {"
X
X
X
X
X
X
X
J
J
J
J
J
c
c
c
n
n
Y
w
N
N
c
c
J
"}
(20,1,1) = {"
J
J
J
J
J
J
J
J
J
J
J
J
J
J
c
c
c
c
c
c
c
c
J
J
"}
