//MAP CONVERTED BY dmm2tgm.py THIS HEADER COMMENT PREVENTS RECONVERSION, DO NOT REMOVE
"a" = (
/turf/unsimulated/floor/void,
/area/precursor/unspace/lounge)
"c" = (
/turf/unsimulated/wall/auto/adventure/icemooninterior,
/area/precursor/unspace/lounge)
"g" = (
/turf/unsimulated/floor/setpieces/bluefloor,
/area/precursor/unspace/lounge)
"t" = (
/turf/unsimulated/floor/void/timewarp,
/area/precursor/unspace/lounge)
"u" = (
/obj/landmark/menhir/room{
	tag = "menhir_room_lounge"
	},
/turf/unsimulated/floor/setpieces/bluefloor,
/area/precursor/unspace/lounge)
"y" = (
/turf/unsimulated/floor/setpieces/bluefloor{
	dir = 4
	},
/area/precursor/unspace/lounge)
"z" = (
/turf/unsimulated/floor/setpieces/bluefloor{
	dir = 8
	},
/area/precursor/unspace/lounge)
"F" = (
/turf/unsimulated/floor/setpieces/bluefloor{
	dir = 1
	},
/area/precursor/unspace/lounge)
"T" = (
/obj/map/light/cyan/menhir,
/turf/unsimulated/floor/setpieces/bluefloor,
/area/precursor/unspace/lounge)
"X" = (
/obj/table/reinforced/auto,
/turf/unsimulated/floor/setpieces/bluefloor,
/area/precursor/unspace/lounge)
"Y" = (
/obj/table/reinforced/auto,
/obj/map/light/cyan/menhir,
/turf/unsimulated/floor/setpieces/bluefloor,
/area/precursor/unspace/lounge)

(1,1,1) = {"
a
a
a
a
a
a
a
a
a
a
c
c
c
c
c
a
a
"}
(2,1,1) = {"
a
c
c
c
c
c
c
c
c
a
c
z
c
z
c
a
a
"}
(3,1,1) = {"
c
c
F
F
F
F
F
F
c
c
c
F
c
F
c
a
a
"}
(4,1,1) = {"
c
y
g
X
g
T
g
g
g
T
g
g
T
g
c
a
a
"}
(5,1,1) = {"
c
y
g
X
g
z
z
g
c
g
c
F
c
F
c
a
a
"}
(6,1,1) = {"
c
y
g
Y
g
z
z
g
c
T
c
z
c
z
c
a
a
"}
(7,1,1) = {"
c
y
g
X
g
g
g
g
c
F
c
c
c
c
c
a
a
"}
(8,1,1) = {"
c
y
g
X
g
T
g
c
c
u
c
c
a
a
a
a
a
"}
(9,1,1) = {"
c
c
F
F
F
F
c
c
t
t
t
c
a
a
a
a
a
"}
(10,1,1) = {"
a
c
c
c
c
c
c
t
t
t
t
t
a
a
a
a
a
"}
(11,1,1) = {"
a
a
a
a
a
a
t
t
t
t
t
t
t
a
a
a
a
"}
(12,1,1) = {"
a
a
a
a
a
t
t
t
t
t
t
t
t
t
a
a
a
"}
(13,1,1) = {"
a
a
a
a
t
t
t
t
t
t
t
t
t
t
t
a
a
"}
(14,1,1) = {"
a
a
a
t
t
t
t
t
t
t
t
t
t
t
t
t
a
"}
(15,1,1) = {"
a
a
t
t
t
t
t
t
t
t
t
t
t
t
t
t
t
"}
(16,1,1) = {"
a
a
t
t
t
t
t
t
t
t
t
t
t
t
t
t
t
"}
(17,1,1) = {"
a
a
t
t
t
t
t
t
t
t
t
t
t
t
t
t
t
"}
(18,1,1) = {"
a
a
t
t
t
t
t
t
t
t
t
t
t
t
t
t
t
"}
