//MAP CONVERTED BY dmm2tgm.py THIS HEADER COMMENT PREVENTS RECONVERSION, DO NOT REMOVE
"a" = (
/turf/unsimulated/floor/void,
/area/space)
"c" = (
/turf/unsimulated/wall/auto/adventure/icemooninterior,
/area/space)
"g" = (
/turf/unsimulated/floor/setpieces/bluefloor,
/area/space)
"j" = (
/turf/unsimulated/floor/setpieces/bluefloor{
	dir = 1
	},
/area/space)
"t" = (
/turf/unsimulated/floor/void/timewarp,
/area/space)
"J" = (
/obj/landmark/menhir/room,
/turf/unsimulated/floor/setpieces/bluefloor,
/area/space)
"K" = (
/obj/map/light/cyan/menhir,
/turf/unsimulated/floor/setpieces/bluefloor,
/area/space)

(1,1,1) = {"
t
t
t
t
t
t
t
t
t
t
t
t
t
t
t
"}
(2,1,1) = {"
t
t
t
t
t
t
t
t
t
t
t
t
t
t
t
"}
(3,1,1) = {"
t
t
t
t
t
t
t
t
t
t
t
t
t
t
t
"}
(4,1,1) = {"
t
t
t
t
t
t
t
t
t
t
t
t
t
t
t
"}
(5,1,1) = {"
a
t
t
t
t
t
t
t
t
t
t
t
t
t
a
"}
(6,1,1) = {"
a
a
t
t
t
t
t
t
t
t
t
t
t
a
a
"}
(7,1,1) = {"
a
a
a
t
t
t
t
t
t
t
t
t
a
a
a
"}
(8,1,1) = {"
a
a
a
a
t
t
t
t
t
t
t
a
a
a
a
"}
(9,1,1) = {"
a
a
a
a
a
t
t
t
t
t
a
a
a
a
a
"}
(10,1,1) = {"
a
a
a
a
a
c
t
t
t
c
a
a
a
a
a
"}
(11,1,1) = {"
a
a
a
a
a
c
c
J
c
c
a
a
a
a
a
"}
(12,1,1) = {"
a
a
a
a
a
a
c
j
c
a
a
a
a
a
a
"}
(13,1,1) = {"
a
a
a
a
a
a
c
K
c
a
a
a
a
a
a
"}
(14,1,1) = {"
a
a
a
a
a
a
c
g
c
a
a
a
a
a
a
"}
(15,1,1) = {"
a
a
a
a
a
a
g
K
g
a
a
a
a
a
a
"}
(16,1,1) = {"
a
a
a
a
a
a
c
c
c
a
a
a
a
a
a
"}
