//MAP CONVERTED BY dmm2tgm.py THIS HEADER COMMENT PREVENTS RECONVERSION, DO NOT REMOVE
"a" = (
/turf/unsimulated/floor/void,
/area/precursor/unspace/botany)
"c" = (
/turf/unsimulated/wall/auto/adventure/icemooninterior,
/area/precursor/unspace/botany)
"g" = (
/turf/unsimulated/floor/setpieces/bluefloor,
/area/precursor/unspace/botany)
"p" = (
/obj/landmark/menhir/room{
	tag = "menhir_room_botany"
	},
/turf/unsimulated/floor/setpieces/bluefloor,
/area/precursor/unspace/botany)
"t" = (
/turf/unsimulated/floor/void/timewarp,
/area/precursor/unspace/botany)
"z" = (
/turf/unsimulated/floor/setpieces/bluefloor{
	dir = 4
	},
/area/precursor/unspace/botany)
"D" = (
/turf/unsimulated/floor/setpieces/bluefloor{
	dir = 1
	},
/area/precursor/unspace/botany)
"M" = (
/obj/machinery/door/unpowered/blue,
/turf/unsimulated/floor/setpieces/bluefloor,
/area/precursor/unspace/botany)
"P" = (
/obj/map/light/cyan/menhir,
/turf/unsimulated/floor/setpieces/bluefloor,
/area/precursor/unspace/botany)

(1,1,1) = {"
a
a
c
a
c
a
c
a
c
a
c
a
c
a
a
"}
(2,1,1) = {"
a
c
c
c
c
c
c
c
c
c
c
c
c
c
a
"}
(3,1,1) = {"
c
c
c
D
D
D
D
c
D
D
D
D
c
c
c
"}
(4,1,1) = {"
a
c
z
g
P
g
g
c
g
g
P
g
z
c
a
"}
(5,1,1) = {"
c
c
z
g
g
g
c
c
c
g
g
g
z
c
c
"}
(6,1,1) = {"
a
c
z
g
g
g
M
P
M
g
g
g
z
c
a
"}
(7,1,1) = {"
c
c
z
P
g
g
c
g
c
g
g
P
z
c
c
"}
(8,1,1) = {"
a
c
c
D
D
D
c
P
c
D
D
D
c
c
a
"}
(9,1,1) = {"
c
c
c
c
c
c
c
D
c
c
c
c
c
c
c
"}
(10,1,1) = {"
a
c
a
c
a
c
c
p
c
c
a
c
a
c
a
"}
(11,1,1) = {"
a
a
a
a
a
c
t
t
t
c
a
a
a
a
a
"}
(12,1,1) = {"
a
a
a
a
a
t
t
t
t
t
a
a
a
a
a
"}
(13,1,1) = {"
a
a
a
a
t
t
t
t
t
t
t
a
a
a
a
"}
(14,1,1) = {"
a
a
a
t
t
t
t
t
t
t
t
t
a
a
a
"}
(15,1,1) = {"
a
a
t
t
t
t
t
t
t
t
t
t
t
a
a
"}
(16,1,1) = {"
a
t
t
t
t
t
t
t
t
t
t
t
t
t
a
"}
(17,1,1) = {"
t
t
t
t
t
t
t
t
t
t
t
t
t
t
t
"}
(18,1,1) = {"
t
t
t
t
t
t
t
t
t
t
t
t
t
t
t
"}
(19,1,1) = {"
t
t
t
t
t
t
t
t
t
t
t
t
t
t
t
"}
(20,1,1) = {"
t
t
t
t
t
t
t
t
t
t
t
t
t
t
t
"}
